1        2       3       4        5        6             
+++++++++++++++++++++++++++++++++++++++++++++++++++++++++
+ v++    +0   0 0+++++ + +        +X X X X +      T     +
+    + + + 00 00 +           A    +            T  T   T +
+  ++  + + 00 00 +   +++++        +        +   T      T w
+   + ++ + 00  00+       ++++++   +        +   T  T   T +
+   +  + + 0   0 +++++++ ++++++   D        +   T  T   T +
+ + ++ + +   0   + +   + + B+++   +        +      T     +
+ +    + +0      +   + + +        +        +   T  T   T +
++  ++++    0 0 0D   +   +        + X X X X+   T      T w
+++++++++++++++++++++++++++++++++++++++++++++++++++++++++